title : title
memorial : memorial
de : de
varios : varios
simplices : simplices
author : autor
joao : joao
curvo : curvo
semmedo : semmedo
date : date
que : que
da : da
india : india
oriental : oriental
america : america
e : e
outras : outras
partes : partes
do : do
mundo : mundo
vem : vem
ao : ao
noſſo : nosso
reino : reino
para : para
remedio : remedio
muitas : muitas
doenças : doenças
no : no
qual : qual
se : se
acharaõ : acharão
as : as
virtudes : virtudes
cada : cada
hũ : hu
o : o
modo : modo
com : com
ſe : se
devem : devem
usar : usar
outra : outra
europa : europa
eſte : este
reyno : reino
muitos : muitos
remedios : remedios
singulares : singulares
conteudas : conteudas
anexas : anexas
a : a
differentes : differentes
pedras : pedras
raizes : raizes
pàos : paos
sementes : sementes
frutos : frutos
mas : mas
porque : porque
nem : nem
das : das
os : os
taes : taes
ſervem : servem
applicar : aplicar
haja : haja
algum : algum
roteiro : roteiro
impreſſo : impresso
enſine : ensine
daqui : daqui
procede : procede
tendo : tendo
peſſoas : pessoas
em : em
suas : suas
casas : casas
ditos : ditos
padecendo : padecendo
varias : varias
enfermidades : enfermidades
facilmente : facilmente
podiaõ : podião
curar : curar
elles : eles
por : por
falta : falta
noticia : noticia
dos : dos
preſtimos : prestimos
tem : tem
ficaõ : ficão
ſem : sem
utilidade : utilidade
alguma : alguma
doentes : doentes
ſaude : saude
eſta : esta
conſideraçaõ : consideração
ſentimento : sentimento
incitou : incitou
minha : minha
curioſidade : curiosidade
zelo : zelo
bem : bem
commum : commum
cuſto : custo
grandes : grandes
diligencias : diligencias
buſcaſſe : buscasse
naõ : não
ſó : só
algumas : algumas
assiſtiraõ : assistirão
na : na
terras : terras
deſcobriſſe : descobrisse
papeis : papeis
manuscritos : manuscritos
informandome : informandome
hun : hun
outros : outros
soubeſſe : soubesse
fundamento : fundamento
sobreditas : sobreditas
pàes : paes
fizeſſe : fizesse
ſocorro : socorro
natureza : natureza
humana : umana
ſerviço : serviço
faço : faço
publico : publico
merecer : merecer
agradecimento : agradecimento
merecerey : merecerei
reprehençaõ : reprehenção
ma : ma
derem : derem
acabarey : acabarei
entender : entender
ha : ha
homens : homens
taõ : tão
ingratos : ingratos
animo : animo
depravado : depravado
fazem : fazem
malicia : malicia
meninos : meninos
innocencia : inocencia
mamaõ : mamão
leite : leite
mordem : mordem
peito : peito
ſuſtentou : sustentou
ou : ou
sejaõ : sejão
páos : páos
oſſos : ossos
frutas : frutas
daõ : dão
moidos : moidos
roçados : roçados
agua : agua
commua : commua
misturados : misturados
arroz : arroz
naturaes : naturaes
daquellas : daquelas
chamaõ : chamão
ambatacanja : ambatacanja
alguns : alguns
çumo : çumo
limaõ : limão
gallego : galego
aquelles : aqueles
febres : febres
bebem : bebem
á : á
entrada : entrada
deſpedida : despedida
dellas : delas
experiencia : experiencia
mouros : mouros
gentios : gentios
aſia : asia
foy : foi
meſtra : mestra
deo : deo
conhecimento : conhecimento
uſo : uso
tambem : tambem
curiosos : curiosos
mostrado : mostrado
proveitos : proveitos
vezes : vezes
reſultaõ : resultão
operaçoens : operaçoens
encontrando : encontrando
gerses : gerses
evacuaçoens : evacuaçoens
medicina : medicina
panditos : panditos
aſſistem : assistem
naquellas : naquelas
també : també
usaõ : usão
deſde : desde
príncipio : príncipio
qualquer : qualquer
deſcarga : descarga
procedente : procedente
dilatando : dilatando
tempo : tempo
neſta : nesta
forma : forma
curaõ : curão
mais : mais
agudas : agudas
malignas : malignas
regulando : regulando
ſangria : sangria
purga : purga
ajuda : ajuda
vomitorio : vomitorio
cordeal : cordeal
maneira : maneira
applique : aplique
tudo : tudo
meſmo : mesmo
inſtante : instante
encontre : encontre
hum : um
outro : outro
antes : antes
faça : faça
ſeu : seu
effeito : effeito
livremente : livremente
medicos : medicos
pessoas : pessoas
ſaõ : são
ſi : si
bezoarticos : bezoarticos
portugal : portugal
mesmas : mesmas
maravilhas : maravilhas
nas : nas
crearaõ : crearão
aſſim : assim
pela : pela
differença : differença
clima : clima
como : como
quando : quando
chegaõ : chegão
cá : cá
já : já
aquelle : aquele
vigor : vigor
tinhaõ : tinhão
q : q
nasceraõ : nascerão
duvida : duvida
reſpondo : respondo
todos : todos
conſervaõ : conservão
deos : deos
creou : creou
quanto : quanto
corpo : corpo
entra : entra
corrupçaõ : corrupção
vemos : vemos
experimentamos : experimentamos
conquistas : conquistas
boticas : boticas
nosso : nosso
compostos : compostos
tornaõ : tornão
enfermos : enfermos
lá : lá
mesmos : mesmos
bons : bons
effeitos : effeitos
fizeraõ : fizerão
vindo : vindo
diversos : diversos
climas : climas
ſendo : sendo
muito : muito
sugeitos : sugeitos
à : a
nenhum : nenum
duraçaõ : duração
larga : larga
perduravel : perduravel
homem : homem
curioſo : curioso
poderá : poderá
moſtrar : mostrar
virão : virão
trinta : trinta
annos : anos
eſtão : estão
hoje : hoje
daquelle : daquele
estado : estado
faziaõ : fazião
iſto : isto
ſuppoſto : suposto
verdade : verdade
experimentada : experimentada
iremos : iremos
tratando : tratando
ſimplices : simplices
relaçaõ : relação
individual : individual
começando : começando
pedra : pedra
bazar : bazar
he : he
conhecida : conhecida
uſada : usada
todo : todo
simplez : simplez
regimento : regimento
natural : natural
naſce : nasce
nos : nos
buchos : buchos
huns : huns
animaes : animaes
muy : mui
ſemelhantes : semelhantes
aos : aos
cabritos : cabritos
primeiramente : primeiramente
nesseſſario : nessessario
examinar : examinar
grande : grande
cuidado : cuidado
verdadeira : verdadeira
falſa : falsa
obra : obra
excelentes : excelentes
efeitos : efeitos
tal : tal
condiçaõ : condição
deve : deve
dar : dar
quantidade : quantidade
vinte : vinte
quatro : quatro
grãos : grãos
vez : vez
dando : dando
sómena : sómena
tres : tres
coſtumaõ : costumão
barbeiros : barbeiros
gente : gente
ordinaria : ordinaria
faz : faz
pouca : pouca
deſte : deste
fica : fica
infamado : infamado
vida : vida
doente : doente
perdida : perdida
dinheiro : dinheiro
mal : mal
gaſtado : gastado
ſuccederia : succederia
foſſe : fosse
deſſem : dessem
ſobredita : sobredita
neceſſario : necessario
principiantes : principiantes
advirtaõ : advirtão
duas : duas
couſas : cousas
importantes : importantes
primeira : primeira
dita : dita
miſturar : misturar
cinco : cinco
ſeis : seis
onças : onças
cozida : cozida
eſcorcioneira : escorcioneira
papoulas : papoulas
cardo : cardo
ſanto : santo
miſturada : misturada
aguas : aguas
deſtilladas : destiladas
erraõ : errão
alvo : alvo
claro : claro
pelas : pelas
razoens : razoens
curioſos : curiosos
podem : podem
ver : ver
polyanthea : poliantea
terceira : terceira
impreſſaõ : impressão
trat : trat
cap : cap
fol : fol
n : n
ſegunda : segunda
couſa : cousa
advertir : advertir
miſturem : misturem
cõmua : cõmua
ſobreditas : sobreditas
colheres : colheres
vehiculo : vehiculo
baſtante : bastante
levar : levar
lugares : lugares
diſtantes : distantes
aonde : aonde
ſervir : servir
mſturando : msturando
ancias : âncias
coraçaõ : coração
vàgados : vagados
faltas : faltas
reſpiraçaõ : respiração
todas : todas
hora : hora
neceſſidade : necessidade
pedir : pedir
ſobre : sobre
ſangrias : sangrias
ſuppreſſoens : supressoens
altas : altas
ourina : ourina
virtude : virtude
façaõ : fação
tomar : tomar
benedicta : benedicta
tartaro : tartaro
emetico : emetico
meya : meia
oitava : oitava
caparroſa : caparrosa
branca : branca
ſangrando : sangrando
dia : dia
braços : braços
caſo : caso
perigoſo : perigoso
apreſſado : apressado
fazerem : fazerem
brevidade : brevidade
ourinaõ : ourinão
atè : ate
ſeptimo : septimo
ordinariamente : ordinariamente
morrem : morrem
razaõ : razão
requeiro : requeiro
parte : parte
comecem : comecem
infallivelmente : infalivelmente
cura : cura
ſejaõ : sejão
baixas : baixas
vomitorios : vomitorios
repetidas : repetidas
conſelho : conselho
funda : funda
cincoenta : cincoenta
oito : oito
curey : curei
felizmente : felizmente
eſtylo : estilo
pódem : pódem
d : d
vſq : vsq
ad : ad
acharàõ : acharão
nomeados : nomeados
eſtando : estando
delles : deles
ungidos : ungidos
me : me
chamàraõ : chamarão
permita : permita
s : s
haver : haver
feito : feito
digreſſaõ : digressão
obriga : obriga
proximos : proximos
aviſo : aviso
importante : importante
preſentes : presentes
futuros : futuros
trornando : trornando
propoſito : proposito
digo : digo
depois : depois
dados : dados
preciſamente : precisamente
neceſſarios : necessarios
dava : dava
quarenta : quarenta
miſturados : misturados
quente : quente
primeiro : primeiro
ſeja : seja
huma : uma
onça : onça
pào : pao
faveira : faveira
ſeca : seca
delle : dele
eroca : eroca
marinha : marinha
deſta : desta
oitavas : oitavas
erva : erva
ſapinha : sapinha
melhor : melhor
chamada : chamada
virga : virga
aurca : aurca
finalmente : finalmente
ſerve : serve
brazar : brazar
applicada : aplicada
faci : faci
facilitar : facilitar
camara : camara
dureyros : dureiros
condição : condição
tome : tome
dias : dias
ſuceſſivos : sucessivos
jejum : jejum
hũa : uma
oytava : oitava
cremores : cremores
verdadeyros : verdadeiros
deſatando : desatando
quartilho : quartilho
borragens : borragens
ameyxas : ameixas
fóra : fóra
muytos : muitos
falſificados : falsificados
hume : ume
lugar : lugar
facilitarem : facilitarem
impediráõ : impediráõ
porèm : porem
quizerem : quizerem
livrarſe : livrarse
eſcrepulo : escrepulo
tomem : tomem
farro : farro
vinho : vinho
branco : branco
feyto : feito
pò : pò
ſubtiliſſimo : subtilissimo
experimentaráõ : experimentaráõ
facilidade : facilidade
composta : composta
cordeaes : cordeaes
compoſtas : compostas
estas : estas
não : não
creadas : creadas
entranhas : entranhas
artificio : artificio
conſtão : constão
ingredientes : ingredientes
eſcolhidos : escolhidos
dotados : dotados
cardiacas : cardiacas
bezoarticas : bezoarticas
artifice : artifice
eſtas : estas
religioſo : religioso
companhia : companhia
jesus : jesus
morador : morador
fórma : fórma
mayores : maiores
menores : menores
conforme : conforme
quer : quer
fazer : fazer
feytas : feitas
mãos : mãos
ſingulares : singulares
ſeguintes : seguintes
ardentes : ardentes
qundo : qundo
enfermo : enfermo
eſtiver : estiver
lhe : lhe
darão : darão
pulverizados : pulverizados
eſcorcioneyra : escorcioneira
cereijas : cereijas
negras : negras
tomando : tomando
mitiga : mitiga
quentura : quentura
ſecura : secura
febre : febre
cauſa : causa
malignidade : malignidade
commetta : commetta
coração : coração
defende : defende
conforta : conforta
alegra : alegra
fraqueza : fraqueza
muyta : muita
velhice : velhice
appetecer : apetecer
daráõ : daráõ
deſfeytos : desfeitos
generoſo : generoso
pareça : pareça
novatos : novatos
erro : erro
temeridade : temeridade
graviſſimos : gravissimos
authores : autores
permittem : permittem
muyto : muito
ſer : ser
generos : generos
promptiſſimo : promptissimo
reparar : reparar
forças : forças
alentar : alentar
eſtá : está
desfalecido : desfalecido
melancolia : melancolia
apertar : apertar
ſaõs : sãos
tenhão : tenhão
póde : póde
ſenão : senão
ouver : ouver
excellente : excelente
borragẽs : borrages
tomada : tomada
raiz : raiz
contrayerva : contraierva
ſerpentaria : serpentaria
virginiana : virginiana
deſtas : destas
efficaz : efficaz
contra : contra
genero : genero
peçonha : peçonha
bebida : bebida
procedida : procedida
mordedura : mordedura
vibora : vibora
lacràos : lacraos
aranha : aranha
venenoſos : venenosos
applicará : aplicará
preſerva : preserva
procederem : procederem
ar : ar
corrupto : corrupto
milagre : milagre
leproſo : leproso
ainda : ainda
confirmados : confirmados
tanto : tanto
dous : dous
mezes : mezes
ſuccſſivos : succssivos
miſturando : misturando
della : dela
antimonio : antimonio
diaphoretico : diaforetico
calcinado : calcinado
reverberado : reverberado
horas : horas
fogo : fogo
fortiſſimo : fortissimo
meyo : meio
levemente : levemente
flor : flor
arvore : arvore
buxo : buxo
purificativa : purificativa
ſangue : sangue
ſalgado : salgado
ſoros : soros
mordazes : mordazes
corroſivos : corrosivos
eſquentadas : esquentadas
figado : figado
tomão : tomão
braſſica : brassica
marina : marina
vimal : vimal
ervas : ervas
efficaciſſima : efficacissima
temperar : temperar
maõ : mão
chea : chea
folhas : folhas
espinheyro : espinheiro
alvar : alvar
chamamos : chamamos
rhamno : rhamno
limaduras : limaduras
oſſo : osso
veado : veado
mata : mata
lombrigas : lombrigas
comichões : comichões
coſtras : costras
boſtelas : bostelas
continuos : continuos
pó : pó
rhim : rhim
ouveſſe : ouvesse
eſtado : estado
infuſão : infusão
butua : butua
faveyra : faveira
ſapinho : sapinho
ourinará : ourinará
livrará : livrará
ſupreſſaõ : supressão
rebelde : rebelde
enha : enha
tomado : tomado
primeyro : primeiro
sangrias : sangrias
suceſſivos : sucessivos
confeſſo : confesso
ingenuamente : ingenuamente
mercè : merce
boa : boa
fortuna : fortuna
inventey : inventei
meu : meu
benzoartico : benzoartico
chamado : chamado
curviano : curviano
bexigas : bexigas
venenoſas : venenosas
uſey : usei
tenho : tenho
bom : bom
conceyto : conceito
ſadeyra : sadeira
offerecem : offerecem
duvidas : duvidas
razões : razões
forçoſas : forçosas
uſar : usar
vejo : vejo
anno : ano
arrobas : arrobas
moralmente : moralmente
impossível : impossível
tanta : tanta
ſejão : sejão
verdadeyras : verdadeiras
alèm : alem
desta : desta
conſta : consta
fidedignas : fidedignas
eſtiverão : estiverão
criaõ : crião
logo : logo
razão : razão
ſalvo : salvo
conſtar : constar
certamente : certamente
pertence : pertence
ás : ás
offerece : offerece
justificada : justificada
deſconfiança : desconfiança
meſmos : mesmos
religioſos : religiosos
goa : goa
merecedoras : merecedoras
toda : toda
eſtimação : estimação
queyxão : queixão
falsificão : falsificão
espalhão : espalhão
decoroſo : decoroso
nome : nome
ſerem : serem
pelos : pelos
padres : padres
prouvera : prouvera
là : la
falſificadores : falsificadores
lisboa : lisboa
quem : quem
falſifica : falsifica
tão : tão
parecidas : parecidas
conhece : conhece
engano : engano
falſidade : falsidade
partem : partem
acha : acha
barro : barro
louça : louça
chamão : chamão
greda : greda
vista : vista
pois : pois
deſtes : destes
enganos : enganos
falſidades : falsidades
eytas : eitas
ſegredo : segredo
padre : padre
gaſpar : gaspar
antonio : antonio
ſua : sua
morte : morte
paſſou : passou
jorge : jorge
ungarete : ungarete
boticarios : boticarios
meſma : mesma
artifices : artifices
arte : arte
pharmaceutica : farmaceutica
tirar : tirar
embaraços : embaraços
conſciencia : consciencia
ſempre : sempre
cujas : cujas
maravilhoſos : maravilhosos
proveytos : proveitos
eſtou : estou
certo : certo
pelo : pelo
viſto : visto
experimentado : experimentado
diſcurſo : discurso
anos : anos
noticias : noticias
ſuas : suas
conquiſtas : conquistas
cartas : cartas
gratulatorias : gratulatorias
guardadas : guardadas
duvidarem : duvidarem
quiserem : quiserem
curas : curas
pareção : pareção
milagroſas : milagrosas
neceſſarias : necessarias
primeyra : primeira
verdadeyramente : verdadeiramente
falſificado : falsificado
vende : vende
corte : corte
debayxo : debaixo
lhes : lhes
eſcrupulo : escrupulo
enganar : enganar
materia : materia
vendendo : vendendo
verdadeyro : verdadeiro
fazendo : fazendo
furtos : furtos
dinheyro : dinheiro
reſtituir : restituir
vidas : vidas
reſtituição : restituição
der : der
dè : de
miſturado : misturado
cozimento : cozimento
pevides : pevides
cidra : cidra
eu : eu
dou : dou
deytem : deitem
oytavas : oitavas
canada : canada
oyto : oito
chicara : chicara
menos : menos
dão : dão
tarão : tarão
continuallo : continualo
tiver : tiver
ſymptomas : simptomas
malignos : malignos
terceyra : terceira
medico : medico
vir : vir
final : final
pernicioſa : perniciosa
maligna : maligna
eſperar : esperar
eſtejaõ : estejão
agonizando : agonizando
donde : donde
ſeguẽ : segue
damnos : damnos
morrerem : morrerem
acudiraõ : acudirão
tarde : tarde
poderia : poderia
ſalvar : salvar
aplicado : aplicado
ſegundo : segundo
inamar : inamar
ficarem : ficarem
parentes : parentes
mortos : mortos
atemorizados : atemorizados
quererem : quererem
occaſiões : occasiões
perigoſos : perigosos
vejaõ : vejão
porco : porco
eſpim : espim
verdadeyra : verdadeira
melhores : melhores
antidotos : antidotos
indía : indía
deyxa : deixa
effeytos : effeitos
val : val
tamanho : tamanho
azeytona : azeitona
pequena : pequena
cuſta : custa
cem : cem
mil : mil
reis : reis
entre : entre
principal : principal
antidoto : antidoto
forte : forte
bezoartico : bezoartico
ella : ela
fina : fina
metendo : metendo
quarto : quarto
amargoſiſſima : amargosissima
amargoſa : amargosa
fizer : fizer
moſtra : mostra
dá : dá
advertindo : advertindo
pura : pura
miſturarem : misturarem
erradamente : erradamente
barbeyros : barbeiros
rude : rude
moderar : moderar
amargor : amargor
deſtemperaõ : destemperão
advertem : advertem
eſtes : estes
pobres : pobres
cegos : cegos
luz : luz
paſſo : passo
abatem : abatem
enfraquecem : enfraquecem
tirão : tirão
vencer : vencer
tomaſſem : tomassem
achão : achão
enganados : enganados
preſos : presos
grilhões : grilhões
advertencias : advertencias
doutos : doutos
experiméntados : experiméntados
cirurgiões : cirurgiões
curão : curão
leygas : leigas
ignorantes : ignorantes
conhecem : conhecem
ſuperficialmente : superficialmente
caſca : casca
cuydão : cuidão
matararáõ : matararáõ
augmentaráõ : augmentaráõ
tirarião : tirarião
tiraſſem : tirassem
quinaquina : quinaquina
agora : agora
ſaverão : saverão
prohibidos : prohibidos
doces : doces
azedos : azedos
tomaõ : tomão
inglaterra : inglaterra
conſiſte : consiste
lho : lho
rebater : rebater
doce : doce
azedo : azedo
deytou : deitou
perder : perder
diſſe : disse
for : for
pouco : pouco
avelãa : avelãa
damno : damno
era : era
foſſem : fossem
tantos : tantos
rebateſſem : rebatessem
apagaſſem : apagassem
rebate : rebate
pòde : pòde
experencias : experencias
permitto : permitto
àquelles : aqueles
coſtumados : costumados
beber : beber
ponto : ponto
tract : tract
num : num
amaragor : amaragor
comettem : comettem
peyor : peior
levados : levados
ruſtico : rustico
medo : medo
atrevem : atrevem
colher : colher
advertirem : advertirem
pequeno : pequeno
doença : doença
venenoſa : venenosa
nunca : nunca
tive : tive
fuy : fui
ſetando : setando
dey : dei
livrey : livrei
obſservey : obsservei
caſa : casa
manoel : manoel
caſtro : castro
guimarães : guimarães
eſcrivaõ : escrivão
deſembargo : desembargo
paço : paço
ſuccedeo : succedeo
dona : dona
antonia : antonia
mauricia : mauricia
religioſa : religiosa
santa : santa
clara : clara
ſcirro : scirro
garganta : garganta
officio : officio
agonia : agonia
rezado : rezado
eſcapou : escapou
vive : vive
beneficio : beneficio
refiro : refiro
caſos : casos
ſuccedidos : succedidos
dada : dada
mayor : maior
enfadar : enfadar
leytores : leitores
deſtemperada : destemperada
ſoluços : soluços
procedidos : procedidos
ventoſidades : ventosidades
pudera : pudera
allegar : alegar
innumeraveis : inumeraveis
exemplos : exemplos
ſenaõ : senão
temèra : temera
accidentes : accidentes
uterinos : uterinos
parece : parece
divino : divino
achey : achei
preſente : presente
quaes : quaes
obrou : obrou
maravilhosos : maravilhosos
dores : dores
colica : colica
mordexim : mordexim
preſentaneos : presentaneos
pontadas : pontadas
cauſadas : causadas
frio : frio
macella : macela
eſtiveſſe : estivesse
infuſaõ : infusão
ave : ave
marias : marias
encantamento : encantamento
eſpadas : espadas
marca : marca
capazes : capazes
reſiſtir : resistir
contender : contender
bezoar : bezoar
tico : tico
povo : povo
eſtimaçaõ : estimação
lama : lama
rua : rua
diz : diz
idade : idade
livrado : livrado
infinitos : infinitos
veneno : veneno
deraõ : derão
matar : matar
eſtavão : estavão
expirando : expirando
polynthea : polintea
impreſaõ : impresão
nomeadas : nomeadas
tirey : tirei
ſepultura : sepultura
teſtemunhas : testemunhas
dentes : dentes
vurtudes : vurtudes
roçado : roçado
dente : dente
ſular : sular
contras : contras
cólica : cólica
grade : grade
contraveneno : contraveneno
poyecto : poiecto
torceduras : torceduras
barriga : barriga
canamor : canamor
cananot : cananot
verde : verde
limos : limos
rio : rio
amarella : amarela
enxofre : enxofre
ambas : ambas
boas : boas
uſaõ : usão
eſtima : estima
moidas : moidas
ſuladas : suladas
ſubtilmente : subtilmente
fonte : fonte
cananor : cananor
fria : fria
uſa : usa
geralmente : geralmente
terá : terá
ſingular : singular
preparar : preparar
ferrada : ferrada
ouro : ouro
virgem : virgem
uſando : usando
manhãs : manhãs
eſquentados : esquentados
padecem : padecem
amagores : amagores
boca : boca
procedem : procedem
grandiſſima : grandissima
comerem : comerem
convertem : convertem
colera : colera
inflamação : inflamação
olhos : olhos
inflammaçaõ : inflammação
gargarejando : gargarejando
coſtuma : costuma
repetir : repetir
declinação : declinação
entrar : entrar
refreſca : refresca
adoça : adoça
acrimonia : acrimonia
humores : umores
certa : certa
acculta : acculta
abſorbente : absorbente
abranda : abranda
incendios : incendios
natures : natures
manifeſto : manifesto
alivio : alivio
amendoadas : amendoadas
te : te
dormir : dormir
incêndio : incêndio
vapores : vapores
havião : havião
conciliar : conciliar
ſomno : somno
ſubirem : subirem
tes : tes
cérebro : cérebro
fizerem : fizerem
terão : terão
romarem : romarem
conhecido : conhecido
marabilhoſa : marabilhosa
ictericias : ictericias
tomanda : tomanda
nove : nove
deytar : deitar
ovo : ovo
freſco : fresco
batido : batido
ouvido : ouvido
peyxe : peixe
boy : boi
ſabemos : sabemos
aproveyta : aproveita
eſquentamentos : esquentamentos
qualidade : qualidade
gallica : galica
camaras : camaras
ſorte : sorte
principalmente : principalmente
bexiga : bexiga
areas : areas
rins : rins
applicaſe : aplicase
moído : moído
ononis : ononis
rilha : rilha
remora : remora
aratri : aratri
aurea : aurea
próprias : próprias
área : área
ardores : ardores
queyxas : queixas
dará : dará
deſtillada : destilada
favas : favas
gálicos : gálicos
darà : dara
co : co
falſas : falsas
hortas : hortas
continuando : continuando
quinze : quinze
candar : candar
vulgarmente : vulgarmente
quadrada : quadrada
feytio : feitio
dado : dado
cor : cor
ferro : ferro
peſada : pesada
trazem : trazem
confins : confins
tartarea : tartarea
joques : joques
dizem : dizem
muytas : muitas
afurão : afurão
pendurão : pendurão
peſcoço : pescoço
cahida : cahida
peytos : peitos
chegada : chegada
carne : carne
serve : serve
atada : atada
musſculo : musculo
perna : perna
eſquerda : esquerda
parto : parto
mulher : mulher
termos : termos
parir : parir
moſtado : mostado
neſte : neste
deſeja : deseja
diligencia : diligencia
baſte : baste
esfregaraõ : esfregarão
oleo : oleo
gergelim : gergelim
daraõ : darão
parira : parira
deitaràs : deitaras
pareas : pareas
criança : criança
riſco : risco
perigo : perigo
mãy : mãi
deitar : deitar
tire : tire
deixarem : deixarem
ficar : ficar
ſahirà : sahira
madre : madre
fòra : fòra
vi : vi
obſervey : observei
gaveas : gaveas
apertada : apertada
poder : poder
aplicou : aplicou
deſcuidaraõ : descuidarão
pario : pario
fahio : fahio
applicalla : aplicala
ſima : sima
recolheſſe : recolhesse
mulheres : mulheres
melindrotas : melindrotas
inimigas : inimigas
remédios : remédios
baſtarà : bastara
esdfregou : esdfregou
estregue : estregue
ventre : ventre
embigo : embigo
roda : roda
alimpe : alimpe
azeite : azeite
unfuſaõ : unfusão
raſpada : raspada
migalha : migalha
muez : muez
fluxos : fluxos
almorreimas : almorreimas
copiolos : copiolos
teymoſos : teimosos
condiçoens : condiçoens
b : b
ba : ba
iguarias : iguarias
adubadas : adubadas
eſpeciarias : especiarias
quentes : quentes
mão : mão
poligano : poligano
herbolarios : herbolarios
andorinha : andorinha
excelente : excelente
curarlas : curarlas
vertigens : vertigens
deſmayos : desmaios
deite : deite
esfregue : esfregue
três : três
cerejas : cerejas
ordinária : ordinária
cozeſle : cozesle
levemento : levemento
manjerona : manjerona
ſucceſſivos : successivos
conhecerà : conhecera
deitada : deitada
quebra : quebra
linha : linha
cidreira : cidreira
cabeça : cabeça
eſtiveſſem : estivessem
cólicas : cólicas
pleurizes : pleurizes
prodigioſa : prodigiosa
roçada : roçada
cabeças : cabeças
macela : macela
tiverem : tiverem
queixa : queixa
medroſos : medrosos
aplicar : aplicar
euſtachio : eustachio
rudio : rudio
lente : lente
prima : prima
padua : padua
galeno : galeno
oraculo : oraculo
louvaõ : louvão
toberano : toberano
remédio : remédio
inflammaçoesns : inflammaçoesns
internas : internas
ajudada : ajudada
ferá : ferá
acompanhada : acompanhada
galeni : galeni
lin : lin
ſimplic : simplic
medicam : medicam
eſtachio : estachio
lib : lib
pleuride : pleuride
mibifol : mibifol
dificuldades : dificuldades
ourinar : ourinar
admiraveis : admiraveis
tenha : tenha
vomitório : vomitório
benedita : benedita
emético : emético
feita : feita
preparação : preparação
roçara : roçara
houver : houver
ajuntando : ajuntando
limão : limão
cozido : cozido
burla : burla
ſemente : semente
bardana : bardana
eſteva : esteva
atando : atando
ſobvre : sobvre
recolher : recolher
tripas : tripas
quebrados : quebrados
embargo : embargo
enſino : ensino
acharà : achara
livro : livro
minhas : minhas
obſervaçoens : observaçoens
latinas : latinas
portuguezas : portuguezas
obs : obs
pag : pag
pizado : pizado
coalhado : coalhado
causſa : causa
quèda : queda
pancada : pancada
adelgaça : adelgaça
capaz : capaz
continue : continue
ciculaçaõ : ciculação
vincetoxico : vincetoxico
cerfolio : cerfolio
ajuntem : ajuntem
eſperma : esperma
ceri : ceri
verbaſco : verbasco
coada : coada
roçarem : roçarem
experimentarà : experimentara
bócios : bócios
alporcas : alporcas
domínio : domínio
roçando : roçando
borrage : borrage
ſangues : sangues
tanchagem : tanchagem
roçou : roçou
aſthma : astma
boſta : bosta
mayo : maio
cobra : cobra
pate : pate
mombaça : mombaça
applica : aplica
esta : esta
gerada : gerada
cobras : cobras
bosques : bosques
ilha : ilha
excede : excede
musculo : musculo
esquerda : esquerda
estiver : estiver
necessário : necessário
sorte : sorte
sahira : sahira
seu : seu
moida : moida
deste : deste
pezo : pezo
trigo : trigo
alfavaca : alfavaca
carapetas : carapetas
esteva : esteva
lançar : lançar
muita : muita
darem : darem
eſcrúpulos : escrúpulos
vitriolo : vitriolo
formado : formado
pilulas : pilulas
seis : seis
gãros : gãros
bichos : bichos
peçonhentos : peçonhentos
dentro : dentro
applicado : aplicado
sobre : sobre
semente : semente
bisnaga : bisnaga
uterino : uterino
ferve : ferve
pur : pur
deu : deu
attribuem : attribuem
caetano : caetano
mello : melo
castro : castro
viso : viso
rey : rei
redonda : redonda
eſcamas : escamas
casca : casca
pinha : pinha
certifica : certifica
dito : dito
senhor : senhor
presentanea : presentanea
consta : consta
experiencias : experiencias
safira : safira
sendo : sendo
prefeitiſſima : prefeitissima
quasi : quasi
milagrosa : milagrosa
abrir : abrir
causa : causa
inchados : inchados
eſfregando : esfregando
inchação : inchação
abrem : abrem
cousa : cousa
necessária : necessária
estarem : estarem
fechados : fechados
gere : gere
nevoa : nevoa
veezs : veezs
succede : succede
antrazes : antrazes
arbunculos : arbunculos
pestilenciais : pestilenciais
exhalar : exhalar
fosse : fosse
fumo : fumo
chaminé : chaminé
assim : assim
certificaõ : certificão
vanhelmonte : vanhelmonte
guaynere : guainere
doutores : doutores
gravissimos : gravissimos
dio : dio
saõ : são
artificiaes : artificiaes
família : família
única : única
daquella : daquela
cidade : cidade
segredo : segredo
destas : destas
mordeduras : mordeduras
posta : posta
advertência : advertência
sangue : sangue
farà : fara
mesma : mesma
alfinete : alfinete
pegar : pegar
deixa : deixa
estar : estar
pegada : pegada
cahir : cahir
deita : deita
rosada : rosada
limparà : limpara
enxugarà : enxugara
hade : hade
postura : postura
està : esta
acabada : acabada
infailivel : infailivel
ter : ter
jà : ja
tirado : tirado
dor : dor
sahir : sahir
inchar : inchar
presteza : presteza
grave : grave
pintas : pintas
manda : manda
picar : picar
pô : pô
picada : picada
ditas : ditas
chamar : chamar
visto : visto
quaisquer : quaisquer
venenosos : venenosos
chupa : chupa
attrahe : attrahe
si : si
digna : digna
admiração : admiração
desfaz : desfaz
inchaçoens : inchaçoens
procedidas : procedidas
venenosas : venenosas
disformes : disformes
sem : sem
descarga : descarga
despejo : despejo
manifesto : manifesto
vomitos : vomitos
suor : suor
onde : onde
desfizesse : desfizesse
pedia : pedia
meite : meite
deitando : deitando
rebenta : rebenta
pedaços : pedaços
criado : criado
doutor : doutor
francisco : francisco
roballo : robalo
freire : freire
mordeo : mordeo
bicho : bicho
venenosa : venenosa
inchou : inchou
braço : braço
disformemente : disformemente
rasgarlhe : rasgarlhe
manga : manga
gibão : gibão
despirem : despirem
estando : estando
pobre : pobre
lacayo : lacaio
insoportaveis : insoportaveis
desmayos : desmaios
applicou : aplicou
brevemente : brevemente
desinchou : desinchou
ficou : ficou
filha : filha
livreiro : livreiro
nova : nova
rosto : rosto
ninguém : ninguém
conhecia : conhecia
tinha : tinha
pedio : pedio
pondolha : pondolha
sarou : sarou
breves : breves
mesmo : mesmo
estime : estime
certissimamente : certissimamente
aproveita : aproveita
este : este
faltou : faltou
proveito : proveito
valeraõ : valerão
seja : seja
ambiçaõ : ambição
falcificaõ : falcificão
pauzari : pauzari
babylonia : babilonia
raras : raras
dizer : dizer
liza : liza
azeitonas : azeitonas
elva : elva
feitio : feitio
efficacissima : efficacissima
quebrar : quebrar
suppressaõ : supressão
baixa : baixa
estimada : estimada
principes : principes
afia : afia
paraguay : paraguai
sua : sua
indias : indias
castella : castela
cadiz : cadiz
quanta : quanta
pugillo : pugilo
recebido : recebido
coará : coará
achicara : achicara
limpará : limpará
estomago : estomago
vomito : vomito
suavidade : suavidade
brandura : brandura
caranguejo : caranguejo
aynaõ : ainão
lodo : lodo
baza : baza
mar : mar
provincia : provincia
china : china
vizinha : vizinha
macào : macao
mete : mete
naquele : naquele
converte : converte
totalmente : totalmente
dura : dura
enchem : enchem
unem : unem
lavrada : lavrada
engastada : engastada
breve : breve
espaço : espaço
metem : metem
nesta : nesta
immoveis : immoveis
vè : ve
marè : mare
vaza : vaza
mate : mate
praya : praia
porem : porem
conversaõ : conversão
viveo : viveo
xavier : xavier
vinagre : vinagre
applicandoa : aplicandoa
desfazer : desfazer
carnosidades : carnosidades
duras : duras
hérnias : hérnias
carnosas : carnosas
peso : peso
subtilíssimo : subtilíssimo
misturado : misturado
puxos : puxos
repetindo : repetindo
galego : galego
freve : freve
abafamentos : abafamentos
soltas : soltas
botada : botada
raízes : raízes
valeriana : valeriana
agreste : agreste
gotta : gotta
coral : coral
peixe : peixe
eſtancar : estancar
poſto : posto
baixos : baixos
poſta : posta
trazido : trazido
atado : atado
eſquerdo : esquerdo
chegado : chegado
cõtra : cõtra
accidétes : accidétes
vágados : vágados
coſtella : costela
preparada : preparada
eſtupores : estupores
priapo : priapo
genital : genital
cavallo : cavalo
marinho : marinho
pao : pao
sec : sec
caſcas : cascas
rabãos : rabãos
provoca : provoca
ſupprimida : suprimida
aoutro : aoutro
obſervando : observando
estes : estes
conſelhos : conselhos
ourin : ourin
eſtupendo : estupendo
sabido : sabido
flores : flores
alquitira : alquitira
aſſeguro : asseguro
maravilhoſa : maravilhosa
pleuriz : pleuriz
manhâa : manhâa
às : as
noites : noites
cear : cear
fustiliſſimo : fustilissimo
ſupreſſoens : supressoens
cõ : cõ
eſp : esp
rgo : rgo
latinos : latinos
tisanas : tisanas
junto : junto
occulta : occulta
meſmas : mesmas
engala : engala
cadeiras : cadeiras
aprove : aprove
i : i
ta : ta
eſtanca : estanca
ſahir : sahir
anel : anel
ſuſp : susp
nde : nde
tira : tira
elefante : elefante
eſpecie : especie
coſtado : costado
rheumatiſm : rheumatism
preparando : preparando
cubra : cubra
maſſa : massa
polme : polme
preparado : preparado
roſada : rosada
ſerá : será
morna : morna
unha : unha
graõ : grão
beſta : besta
animal : animal
língua : língua
etiopes : etiopes
chama : chama
nhumbo : numbo
portugueza : portugueza
fermoſo : fermoso
perfeito : perfeito
cauda : cauda
pello : pelo
caſco : casco
fendido : fendido
cabra : cabra
naqueles : naqueles
contornos : contornos
manchados : manchados
tigres : tigres
raros : raros
caſtanho : castanho
só : só
unhas : unhas
pè : pe
ſerventia : serventia
dà : da
preſtimo : prestimo
circunſtancia : circunstância
tirada : tirada
metida : metida
perde : perde
ſugeito : sugeito
repetidos : repetidos
inſtincto : instincto
vê : vê
ameaçado : ameaçado
accidente : accidente
passa : passa
força : força
grão : grão
trazendo : trazendo
umſculo : umsculo
dedo : dedo
engaſtoada : engastoada
toque : toque
intermitentes : intermitentes
escrúpulo : escrúpulo
acidente : acidente
bese : bese
vanelmoncio : vanelmoncio
asthma : astma
est : est
caducum : caducum
pulmonis : pulmonis
eſpinhaço : espinhaço
zuchi : zuchi
zuichi : zuichi
angola : angola
humas : umas
cuſpidora : cuspidora
perseguida : perseguida
querem : querem
eſguicha : esguicha
cuſpinho : cuspinho
delgado : delgado
cahe : cahe
log : log
ergue : ergue
collo : colo
enche : enche
papo : papo
perſegue : persegue
selhe : selhe
acodem : acodem
penetra : penetra
cega : cega
maldade : maldade
pozlhe : pozlhe
ſecaõ : secão
traga : traga
tirarem : tirarem
ossos : ossos
morta : morta
enterra : enterra
paſſaõ : passão
apodrece : apodrece
deſpegaõ : despegão
alimpaõ : alimpão
guardaõ : guardão
applicallos : aplicalos
enfermidade : enfermidade
tenhaõ : tenhão
infiaõ : infião
fio : fio
retroz : retroz
penduraõ : pendurão
gargantilha : gargantilha
corpulencia : corpulencia
achaõ : achão
fortes : fortes
javali : javali
comprimento : comprimento
ú : ú
palmo : palmo
diga : diga
madurar : madurar
apoſtemas : apostemas
leicentos : leicentos
applicando : aplicando
ſobres : sobres
ſahirem : sahirem
ſarampãos : sarampãos
volatil : volatil
iſſo : isso
pleuizes : pleuizes
boens : boens
montez : montez
lubriliſſimo : lubrilissimo
mistu : mistu
rado : rado
lambedor : lambedor
morno : morno
bebedolhe : bebedolhe
firma : firma
calcas : calcas
aſſegurar : assegurar
experi : experi
ncia : ncia
comdição : comdição
aplique : aplique
qie : qie
acabe : acabe
ſarar : sarar
peculio : peculio
revelo : revelo
capitulo : capitulo
manica : manica
creada : creada
tomou : tomou
também : também
eſerupulo : eserupulo
tiſana : tisana
principio : principio
fim : fim
ſuar : suar
admiravel : admiravel
eficazmente : eficazmente
eſtomago : estomago
comſervar : comservar
comer : comer
nelle : nele
vomite : vomite
faſtio : fastio
comforta : comforta
excita : excita
vontade : vontade
impedir : impedir
feridas : feridas
freſcas : frescas
moída : moída
fique : fique
enchendo : enchendo
vaõ : vão
ferida : ferida
elle : ele
ficarà : ficara
chagas : chagas
podres : podres
aplicada : aplicada
chaga : chaga
ungento : ungento
fará : fará
ſarara : sarara
nesseſſitar : nessessitar
humano : umano
eficaz : eficaz
herpes : herpes
moendo : moendo
pondo : pondo
pos : pos
aplicando : aplicando
ſubaõ : subão
diante : diante
xeringola : xeringola
lançada : lançada
contrapeçonha : contrapeçonha
ſubtiliſſimamente : subtilissimamente
loanda : loanda
untando : untando
gengivas : gengivas
fararà : farara
maravilhoſamente : maravilhosamente
face : face
cova : cova
doer : doer
rira : rira
rve : rve
ouvidos : ouvidos
gua : gua
aquentada : aquentada
prata : prata
laçando : laçando
gottas : gottas
eſtiveraõ : estiverão
affirmaõ : affirmão
ſubtiliſſimamtente : subtilissimamtente
pulverizado : pulverizado
barrando : barrando
reſta : resta
fontes : fontes
miſiturada : misiturada
tranchagem : tranchagem
peſſoa : pessoa
houve : houve
confiada : confiada
atreveo : atreveo
xarope : xarope
hera : hera
terreſtre : terrestre
unguka : unguka
cabalina : cabalina
curava : curava
cerramente : cerramente
bofe : bofe
inteiro : inteiro
credito : credito
certeza : certeza
infalível : infalível
duvidaria : duvidaria
aproveitar : aproveitar
ſara : sara
caõ : cão
fino : fino
curando : curando
abertas : abertas
m : m
niaca : niaca
ſupremo : supremo
g : g
nero : nero
cautela : cautela
qualque : qualque
género : género
intallivelmente : intalivelmente
converterà : convertera
preſentaneo : presentaneo
páo : páo
molho : molho
cesfelio : cesfelio
ſupprimia : suprimia
rpincipalmete : rpincipalmete
entrarem : entrarem
capelladas : capeladas
inflammaçoens : inflammaçoens
peripneumonia : peripneumonia
interiores : interiores
reſiſte : resiste
cypò : cipò
aeſta : aesta
portuguezes : portuguezes
gentio : gentio
pieaquanha : pieaquanha
pica : pica
há : há
groſſo : grosso
hem : hem
asi : asi
eſcuro : escuro
benigno : benigno
obrar : obrar
rariſſimas : rarissimas
faltaõ : faltão
efeito : efeito
deſejado : desejado
tacs : tacs
provocar : provocar
violenvia : violenvia
provoque : provoque
deitallas : deitalas
qualder : qualder
eſerupulos : eserupulos
citava : citava
toma : toma
caldo : caldo
galinha : galinha
repete : repete
solor : solor
fobreditas : fobreditas
ſinguar : singuar
nephriticas : nefriticas
bochechas : bochechas
alimpar : alimpar
limgua : limgua
groſſa : grossa
levando : levando
baixo : baixo
províncias : províncias
localizações : localizações
calumba : calumba
quaſi : quasi
beberà : bebera
manhã : manhã
nao : nao
importa : importa
frios : frios
moerà : moera
mordechim : mordechim
indigeſtoens : indigestoens
forem : forem
dàrà : dara
maravilho : maravilho
sos : sos
tartato : tartato
caparrola : caparrola
ſangrado : sangrado
diſto : disto
eſpargo : espargo
untarà : untara
manhãa : manhãa
eſteja : esteja
mortal : mortal
lha : lha
lançarà : lançara
moer : moer
pedaço : pedaço
maſtigue : mastigue
engulir : engulir
deitará : deitará
refinada : refinada
cuſpa : cuspa
anfião : anfião
então : então
refinado : refinado
unico : unico
esfregar : esfregar
opio : opio
franſcisco : franscisco
freyre : freire
fiſico : fisico
mór : mór
rafael : rafael
bluteau : bluteau
tomo : tomo
vocabulario : vocabulario
portuguez : portuguez
latino : latino
col : col
uzagre : uzagre
lavatorio : lavatorio
menſal : mensal
faltar : faltar
pedacinho : pedacinho
tirará : tirará
eryſipela : erisipela
havendo : havendo
tocado : tocado
untar : untar
terçans : terçans
quartas : quartas
rebeldes : rebeldes
serpentaria : serpentaria
naſcida : nascida
caſtella : castela
defenſivo : defensivo
ſoccorre : soccorre
eſtupenda : estupenda
caſcavel : cascavel
inglezes : inglezes
chamao : chamao
rattle : rattle
snakes : snakes
sapuche : sapuche
deſcuberto : descuberto
planta : planta
coſtumão : costumão
folha : folha
conheça : conheça
nhecida : nhecida
livre : livre
trouxer : trouxer
durma : durma
charneca : charneca
tocar : tocar
peçonhento : peçonhento
venenos : venenos
enformos : enformos
obſtrucçoens : obstrucçoens
circulação : circulação
joão : joão
lopes : lopes
pinheiro : pinheiro
terçãs : terçãs
quartãs : quartãs
contrafebres : contrafebres
ſubril : subril
aberta : aberta
caneladas : caneladas
cobrindo : cobrindo
pòs : pòs
pontada : pontada
opilaçoens : opilaçoens
continuada : continuada
milagroſos : milagrosos
caſta : casta
viboras : viboras
ferem : ferem
cabe : cabe
terra : terra
amortecida : amortecida
deſmayada : desmaiada
fallar : falar
mover : mover
acção : acção
vivente : vivente
cujo : cujo
eſperança : esperança
fazerlhe : fazerlhe
alto : alto
lanceta : lanceta
improvito : improvito
falla : fala
parreira : parreira
brava : brava
cria : cria
rios : rios
sena : sena
beberem : beberem
apoſtema : apostema
abſeſſo : absesso
interior : interior
novo : novo
reſolverá : resolverá
desfará : desfará
poucos : poucos
velho : velho
rebentar : rebentar
fora : fora
deſtéperado : destéperado
fòrma : fòrma
abſeſſos : absessos
exteriores : exteriores
reſolve : resolve
deſfaz : desfaz
ſete : sete
araujo : araujo
morando : morando
igreja : igreja
annunciada : anunciada
inchada : inchada
exceſſiva : excessiva
deformidade : deformidade
pareceo : pareceo
impoſſivel : impossivel
eſcapar : escapar
ſarou : sarou
neceſſitar : necessitar
cevadas : cevadas
unta : unta
esfrega : esfrega
reſolver : resolver
deſcoalhar : descoalhar
eſtar : estar
reprezado : reprezado
pode : pode
circular : circular
circula : circula
azeda : azeda
azedar : azedar
pancadas : pancadas
quedas : quedas
tormentilla : tormentila
ſolda : solda
pentafilão : pentafilão
doloroſa : dolorosa
eſquinencia : esquinencia
garrotilho : garrotilho
gargariſmos : gargarismos
parcas : parcas
danda : danda
facilita : facilita
molas : molas
deſinchar : desinchar
tumor : tumor
eryſipelas : erisipelas
panos : panos
picados : picados
mornos : mornos
deixem : deixem
ſecar : secar
inflammação : inflammação
lavando : lavando
queixoſa : queixosa
ſo : so
quizer : quizer
cozer : cozer
laſquinhas : lasquinhas
miudas : miudas
machucará : machucará
largar : largar
hernias : hernias
ventoſas : ventosas
aquoſas : aquosas
carnoſas : carnosas
repentindo : repentindo
pannos : panos
enſopados : ensopados
pra : pra
ſabe : sabe
verdadeiro : verdadeiro
canela : canela
certificar : certificar
mathias : matias
mendes : mendes
ouvidor : ouvidor
alfandega : alfandega
quebraduras : quebraduras
gemas : gemas
ovos : ovos
poſſo : posso
apontar : apontar
rainha : rainha
hungria : hungria
nho : nho
xaqueca : xaqueca
rolado : rolado
murta : murta
barrar : barrar
teſta : testa
orelha : orelha
bebendo : bebendo
baço : baço
manhaãs : manhaãs
aguado : aguado
exercicio : exercicio
puder : puder
is : is
noite : noite
luis : luis
serrão : serrão
pimental : pimental
cos : cos
mografo : mografo
mòr : mòr
teſtemunha : testemunha
eſperanças : esperanças
moradora : moradora
viſta : vista
poço : poço
taboas : taboas
deſenfreadas : desenfreadas
antigas : antigas
ſuſpeitoulhe : suspeitoulhe
tinhão : tinhão
feitiço : feitiço
mantando : mantando
lentamente : lentamente
baldados : baldados
azedumes : azedumes
carnoſidades : carnosidades
ſiringando : siringando
cano : cano
condiçao : condiçao
vomitoria : vomitoria
terceiro : terceiro
comece : comece
conhecerão : conhecerão
conselho : conselho
pugaçoens : pugaçoens
doze : doze
bellas : belas
criada : criada
havia : havia
padecia : padecia
purgação : purgação
obedecia : obedecia
conjunção : conjunção
achaques : achaques
pardos : pardos
religioso : religioso
lembra : lembra
ſuffocado : suffocado
flatos : flatos
podia : podia
reſpirar : respirar
livrou : livrou
melancolicos : melancolicos
lançando : lançando
nellas : nelas
finiſſimo : finissimo
pulverizada : pulverizada
salvagem : salvagem
leicenços : leicenços
apeſtados : apestados
un : un
tar : tar
offendida : offendida
cão : cão
danado : danado
franciſco : francisco
cavalleiro : cavaleiro
profeſſo : professo
ordem : ordem
santiago : santiago
dera : dera
região : região
fleumonoſa : fleumonosa
largos : largos
tempos : tempos
madurou : madurou
rebentou : rebentou
deitou : deitou
humor : umor
ſaã : saã
ictericia : ictericia
terebentina : terebentina
pirolas : pirolas
centaurca : centaurca
menor : menor
cozidas : cozidas
hua : uma
ajudas : ajudas
aproveitão : aproveitão
intermittentes : intermittentes
duvido : duvido
ſão : são
afamadas : afamadas
pedro : pedro
caſtello : castelo
grupo : grupo
michel : michel
alexandre : alexandre
raíz : raíz
divina : divina
ꭍuas : suas
naꭍce : nasce
vizinho : vizinho
cetuval : cetuval
chamam : chamam
troya : troia
sabemos : sabemos
eꭍcreveꭍꭍe : escrevesse
porém : porém
ef : ef
feitos : feitos
ꭍaõ : são
qualificadas : qualificadas
teꭍtemunhas : testemunhas
tuas : tuas
virtu : virtu
inclinante : inclinante
cuja : cuja
cauꭍa : causa
ꭍe : se
uꭍar : usar
moderada : moderada
fervura : fervura
canadas : canadas
coza : coza
machucada : machucada
deꭍopila : desopila
veas : veas
conjunçaõ : conjunção
parecem : parecem
hydropicas : hidropicas
tempò : tempò
irá : irá
deꭍcobrindo : descobrindo
ora : ora
fallo : falo
ꭍó : só
temos : temos
ꭍeus : seus
preꭍtimos : prestimos
unguento : unguento
bicuiva : bicuiva
janeiro : janeiro
canudos : canudos
bicuivo : bicuivo
ꭍemente : semente
fruto : fruto
becoybeira : becoibeira
conꭍta : consta
ꭍer : ser
efficaciꭍꭍimo : efficacissimo
eꭍtejaõ : estejão
procedaõ : procedão
nervos : nervos
encolhimento : encolhimento
eꭍteja : esteja
tolhido : tolhido
aleijado : aleijado
maravilhoso : maravilhoso
naquei : naquei
las : las
dureza : dureza
inchaçõ : inchaçõ
neceꭍꭍario : necessario
couꭍas : cousas
deꭍejàdo : desejado
formentaçaõ : formentação
reꭍguardo : resguardo
ab : ab
poros : poros
ꭍegunda : segunda
proceda : proceda
frialdade : frialdade
queixoꭍa : queixosa
moderadamente : moderadamente
parecer : parecer
baꭍta : basta
penetre : penetre
dentroem : dentroem
deꭍte : deste
meꭍma : mesma
efficacia : efficacia
esfregando : esfregando
ofendida : ofendida
maçaa : maçaa
leaõ : leão
aꭍꭍim : assim
bucho : bucho
vacas : vacas
gera : gera
uma : uma
laranja : laranja
pequenam : pequenam
leoens : leoens
bola : bola
maça : maça
eꭍta : esta
deꭍꭍa : dessa
inꭍtante : instante
parem : parem
deitaõ : deitão
efficazmente : efficazmente
maçao : maçao
elefantes : elefantes
velhos : velhos
maçãs : maçãs
bolas : bolas
tamanhas : tamanhas
deꭍta : desta
achado : achado
excllente : exclente
amarga : amarga
eꭍte : este
miꭍturada : misturada
fanto : fanto
abafa : abafa
ꭍuar : suar
coꭍta : costa
abre : abre
triaga : triaga
braꭍilica : brasilica
collegio : colegio
religioꭍos : religiosos
bahia : bahia
compoꭍta : composta
plantas : plantas
naꭍcem : nascem
braꭍil : brasil
dotadas : dotadas
excellentes : excelentes
ꭍoper : soper
ꭍi : si
ꭍervir : servir
magna : magna
compoem : compoem
curao : curao
venenoꭍa : venenosa
maꭍtigallas : mastigalas
moꭍtrado : mostrado
ꭍenaõ : senão
inferior : inferior
efficaciꭍꭍima : efficacissima
cotra : cotra
excepto : excepto
corroꭍivos : corrosivos
ꭍolimaõ : solimão
roꭍalgar : rosalgar
eꭍtes : estes
ate : ate
miꭍturam : misturam
mucilagens : mucilagens
marmelo : marmelo
ꭍeguros : seguros
animais : animais
até : até
calda : calda
licor : licor
iꭍo : iso
sinta : sinta
aliviado : aliviado
untandolhe : untandolhe
pulꭍos : pulsos
nariz : nariz
poꭍta : posta
emplaꭍtro : emplastro
desfeita : desfeita
intrinꭍeca : intrinseca
eꭍtomago : estomago
cauꭍadas : causadas
inteꭍtinos : intestinos
eꭍtancar : estancar
area : area
ciuretica : ciuretica
miado : miado
eꭍpargo : espargo
rilhaboy : rilhaboi
achaque : achaque
cauꭍada : causada
intemperança : intemperança
parleꭍia : parlesia
epilepꭍia : epilepsia
apoplexia : apoplexia
juntamente : juntamente
geraes : geraes
ꭍabem : sabem
putrefaçaõ : putrefação
epidemicas : epidemicas
ianto : ianto
eꭍcorcioneira : escorcioneira
ꭍarampaõ : sarampão
ajudando : ajudando
ꭍahir : sahir
ꭍuffocaçaõ : suffocação
convulꭍaõ : convulsão
retençaõ : retenção
menꭍtruos : menstruos
opilaçaõ : opilação
expellir : expelir
corroborar : corroborar
quaꭍi : quasi
crianças : crianças
colicas : colicas
canelas : canelas
oꭍꭍo : osso
sol : sol
deꭍtes : destes
oꭍꭍos : ossos
eꭍponjoꭍos : esponjosos
deꭍtilla : destila
apra : apra
vazo : vazo
limpo : limpo
guarda : guarda
vidro : vidro
fechado : fechado
eꭍtima : estima
eꭍpecifico : especifico
aꭍthma : astma
reꭍpiraçao : respiraçao
communique : communique
ꭍua : sua
eꭍtiver : estiver
ꭍeja : seja
penetrativo : penetrativo
caꭍcavel : cascavel
brasil : brasil
venenoꭍas : venenosas
mordendo : mordendo
communicaõ : communicão
repentinamente : repentinamente
peꭍtilente : pestilente
ꭍangue : sangue
furia : furia
ꭍahe : sahe
eꭍgotar : esgotar
morrer : morrer
peꭍꭍoa : pessoa
mordida : mordida
xenninga : xeninga
ingleses : ingleses
rattheinakes : ratteinakes
tangendo : tangendo
ouça : ouça
longe : longe
fugir : fugir
peꭍcoço : pescoço
preꭍervar : preservar
cágados : cágados
ꭍobre : sobre
obꭍervou : observou
ꭍobrinha : sobrinha
franciꭍco : francisco
ferreira : ferreira
nobre : nobre
nomeyo : nomeio
eꭍcuꭍar : escusar
enfado : enfado
eꭍcapaõ : escapão
peꭍꭍoas : pessoas
mordidas : mordidas
venenoꭍiꭍꭍima : venenosissima
unicorne : unicorne
inhame : inhame
anhame : anhame
ꭍerpentaria : serpentaria
eꭍterco : esterco
acabado : acabado
maçaõ : mação
vaca : vaca
criao : criao
bols : bols
redondas : redondas
laranjas : laranjas
sãõ : sãõ
parda : parda
leves : leves
eꭍtaõ : estão
cheas : cheas
cabelos : cabelos
bala : bala
mação : mação
camarentos : camarentos
alivia : alivia
falha : falha
comꭍta : comsta
feitas : feitas
eꭍerança : eserança
pires : pires
esula : esula
encerraõ : encerrão
trazida : trazida
infusaõ : infusão
purgar : purgar
groꭍꭍos : grossos
hydropicos : hidropicos
paraliticos : paraliticos
alporquentos : alporquentos
robusꭍtos : robusstos
meiao : meiao
curioꭍos : curiosos
martim : martim
rullando : rulando
palatinos : palatinos
curou : curou
eíula : eíula
fel : fel
ꭍ : s
criam : criam
amarellas : amarelas
açafraõ : açafrão
eꭍtas : estas
comdiçaõ : comdição
evacuado : evacuado
miꭍturando : misturando
ꭍeis : seis
morangos : morangos
grama : grama
caꭍa : casa
ꭍegredo : segredo
ꭍendo : sendo
acheẏ : achei
occaꭍiaõ : occasião
eꭍcrupuloꭍos : escrupulosos
vendaõ : vendão
dizendo : dizendo
reveleẏ : revelei
inventou : inventou
curioꭍidade : curiosidade
ninguem : ninguem
ꭍabe : sabe
compoꭍtos : compostos
entraõ : entrão
fabrica : fabrica
diꭍꭍo : disso
peça : peça
ꭍegredos : segredos
digaõ : digão
ꭍem : sem
eꭍcrupulo : escrupulo
graves : graves
daninos : daninos
ꭍeguem : seguem
vender : vender
adulterados : adulterados
verdadeiros : verdadeiros
largis : largis
peꭍꭍegueẏro : pessegueiro
coradas : coradas
perꭍia : persia
turquia : turquia
poucas : poucas
muẏ : mui
arvores : arvores
caꭍca : casca
introduzido : introduzido
loꭍna : losna
uvas : uvas
paꭍꭍadas : passadas
impreꭍꭍaõ : impressão
cezoens : cezoens
parrilha : parrilha
azougue : azougue
gallico : galico
citado : citado
rameloꭍos : ramelosos
humidos : umidos
inflammados : inflammados
eꭍcropulo : escropulo
infuꭍaõ : infusão
rofada : rofada
lingua : lingua
dangya : dangia
catenga : catenga
catubia : catubia
fulado : fulado
moido : moido
ꭍubtilmente : subtilmente
ꭍeu : seu
inchaçao : inchaçao
doloroꭍa : dolorosa
naꭍcente : nascente
poente : poente
prejudical : prejudical
meẏa : meia
pernas : pernas
conꭍideravel : consideravel
daiz : daiz
miꭍturado : misturado
anagalia : anagalia
marugem : marugem
eꭍpirito : espirito
alcanforado : alcanforado
erẏꭍipelas : erisipelas
deixe : deixe
ꭍecar : secar
parleꭍias : parlesias
sulada : sulada
paralitica : paralitica
maravilhoꭍo : maravilhoso
bebido : bebido
eꭍtando : estando
deꭍeꭍperado : desesperado
untou : untou
molhou : molhou
melhorou : melhorou
tirou : tirou
teve : teve
maravilhoꭍos : maravilhosos
deitandolhes : deitandolhes
pentem : pentem
alimpa : alimpa
contraẏerva : contraierva
caꭍtella : castela
meꭍmo : mesmo
malicioꭍamente : maliciosamente
alguem : alguem
poderoꭍo : poderoso
affim : affim
maligniꭍꭍimas : malignissimas
joaõ : joão
curado : curado
tantas : tantas
numero : numero
eꭍtavaõ : estavão
fuẏ : fui
dandolhes : dandolhes
bozoartico : bozoartico
invento : invento
compoꭍiçaõ : composição
eꭍcaparaõ : escaparão
poderaõ : poderão
meꭍmos : mesmos
reꭍuꭍcitados : resuscitados
cujos : cujos
nomes : nomes
apontados : apontados
deꭍde : desde
conjuçaõ : conjução
mental : mental
jenum : jenum
meẏo : meio
perꭍeguido : perseguido
almiꭍcar : almiscar
desfazendo : desfazendo
eꭍpremida : espremida
alꭍavaca : alsavaca
angelica : angelica
certaõ : certão
matos : matos
tamanhos : tamanhos
ameixa : ameixa
ꭍama : sama
publica : publica
conꭍtante : constante
fritos : fritos
mandou : mandou
ii : ii
meringanga : meringanga
artificioꭍa : artificiosa
enꭍinou : ensinou
religioꭍo : religioso
conꭍerva : conserva
receita : receita
eꭍtillicidios : estilicidios
ꭍchirro : schirro
moribundos : moribundos
apertados : apertados
pòdem : pòdem
ꭍciatica : sciatica
incriveis : incriveis
mel : mel
abelhas : abelhas
marmelada : marmelada
artequim : artequim
fruta : fruta
comprida : comprida
ameyxa : ameixa
faragoçana : faragoçana
quinas : quinas
certas : certas
traz : traz
ql : ql
nego : nego
negocio : negocio
tinta : tinta
ſeculos : seculos
ſoube : soube
tiveſſe : tivesse
compadecido : compadecido
novas : novas
permittio : permittio
le : le
descubrissem : descubrissem
novos : novos
curaſſem : curassem
pudèra : pudera
confirmação : confirmação
deſcubrio : descubrio
lepra : lepra
deſeſperadas : desesperadas
tomalla : tomala
casualmente : casualmente
embarcaçaõ : embarcação
carregada : carregada
artequins : artequins
algũas : alguas
noytes : noites
paſſageyro : passageiro
vinha : vinha
embarcação : embarcação
encoſtado : encostado
ſacos : sacos
cheyos : cheios
achou : achou
perfeytamente : perfeitamente
quiriato : quiriato
ralado : ralado
subtiliſſimo : subtilissimo
monguz : monguz
animalejo : animalejo
foraõ : forão
pelejar : pelejar
ſente : sente
ferido : ferido
peleja : peleja
vay : vai
buſcar : buscar
maſtigando : mastigando
volta : volta
continuar : continuar
briga : briga
ſalvando : salvando
p : p
ſeus : seus
benediɛta : benedita
azeyte : azeite
ſal : sal
inflammações : inflammações
coco : coco
maldiva : maldiva
fundo : fundo
rim : rim
naſcem : nascem
pegados : pegados
negra : negra
miolo : miolo
caſquinha : casquinha
come : come
pardo : pardo
pucaros : pucaros
barquinhas : barquinhas
pès : pes
azas : azas
dobrado : dobrado
valor : valor
melancolicas : melancolicas
obſtrucções : obstrucções
abſorver : absorver
usando : usando
coquinho : coquinho
melinde : melinde
macoma : macoma
macomeyra : macomeira
corta : corta
ſerra : serra
felpuda : felpuda
usa : usa
abater : abater
confortar : confortar
reſfriado : resfriado
relaxado : relaxado
milhomẽs : milhomes
certão : certão
braſil : brasil
preparados : preparados
lançados : lançados
grangrena : grangrena
curativo : curativo
corra : corra
gangrena : gangrena
univerſal : universal
ardente : ardente
preſentaneamente : presentaneamente
vomitiva : vomitiva
felicidade : felicidade
caminho : caminho
tambuape : tambuape
batatas : batatas
campo : campo
homẽs : homes
batata : batata
fava : fava
quartans : quartans
queijo : queijo
trio : trio
roçar : roçar
liquido : liquido
deytaõ : deitão
lagrimaes : lagrimaes
perfeyto : perfeito
juizo : juizo
comſta : comsta
deytarse : deitarse
tornará : tornará
quaeſquer : quaesquer
mordèraõ : morderão
tam : tam
deſacordada : desacordada
ſarrafaçaduras : sarrafaçaduras
ſobrancelhas : sobrancelhas
moleyra : moleira
untem : untem
favor : favor
vivirà : vivira
aſſombrados : assombrados
endemoninhados : endemoninhados
và : va
demonio : demonio
deyte : deite
deytado : deitado
deſpertar : despertar
bebados : bebados
vira : vira
furo : furo
aquella : aquela
arrebente : arrebente
enxaqueca : enxaqueca
feyta : feita
venta : venta
contraria : contraria
tabaco : tabaco
regra : regra
chamados : chamados
ignorantemente : ignorantemente
ſubio : subio
afoga : afoga
gengibre : gengibre
meterem : meterem
miſtura : mistura
ventas : ventas
modorra : modorra
infallivelmẽte : infalivelmete
acordará : acordará
eſpirrará : espirrará
acordar : acordar
eſpirrar : espirrar
ſocorre : socorre
grandemente : grandemente
àquellas : aquelas
pondolhe : pondolhe
darlhe : darlhe
primeyros : primeiros
ſegura : segura
reprezar : reprezar
convem : convem
deyxar : deixar
deſcarregar : descarregar
leva : leva
palma : palma
acorda : acorda
profundo : profundo
ſentem : sentem
farjadas : farjadas
calo : calo
ſubtil : subtil
ficão : ficão
confessar : confessar
reſtamento : restamento
quero : quero
ſomnos : somnos
peſadiſſimos : pesadissimos
enſinarlhes : ensinarlhes
facil : facil
acordaraõ : acordarão
tornar : tornar
tomarem : tomarem
trociſcos : trociscos
alandal : alandal
papel : papel
mataborraõ : mataborrão
certificarſe : certificarse
milagroſa : milagrosa
modorras : modorras
affeɛtos : affetos
ſoporoſos : soporosos
impreſſão : impressão
eſtarem : estarem
pranteados : pranteados
invenciveis : invenciveis
ſobredito : sobredito
peço : peço
chriſto : christo
deſprezem : desprezem
ginsão : ginsão
frangão : frangão
últimos : últimos
paroxiſmos : paroxismos
porção : porção
franga : franga
proſtrado : prostrado
deſfalecido : desfalecido
eſtalfado : estalfado
faſtientos : fastientos
appetite : apetite
moçuaquim : moçuaquim
coſta : costa
moçambique : moçambique
defronte : defronte
ilhas : ilhas
querimba : querimba
contacto : contacto
cara : cara
maleficios : maleficios
ſulprende : sulprende
aranhas : aranhas
peru : peru
peçonhentas : peçonhentas
matão : matão
infallivel : infalivel
leyte : leite
figueyra : figueira
cortando : cortando
faca : faca
figueyras : figueiras
differem : differem
perdem : perdem
chega : chega
inverno : inverno
comſervão : comservão
verdes : verdes
altiſſima : altissima
providencia : providencia
total : total
quiz : quiz
ſoccorro : soccorro
angariani : angariani
hũs : hus
caroços : caroços
compridos : compridos
tamaras : tamaras
deſfazer : desfazer
difficuldades : difficuldades
feculentos : feculentos
deytando : deitando
ourinas : ourinas
hydropeſias : hidropesias
confição : confição
pertende : pertende
seguinte : seguinte
limado : limado
deytaráõ : deitaráõ
panela : panela
deyxaráõ : deixaráõ
ferverá : ferverá
quartilhos : quartilhos
fiquem : fiquem
ſol : sol
comendo : comendo
paſſado : passado
ſuppreſſões : supressões
ſeguinte : seguinte
terceyro : terceiro
ſummario : summario
preſſa : pressa
crença : crença
tejaõ : tejão
bayxas : baixas
anteponho : anteponho
advirto : advirto
falhar : falhar
maravilhoſo : maravilhoso
tornarey : tornarei
effeyto : effeito
quintilo : quintilo
vejão : vejão
ungidas : ungidas
tidas : tidas
incuraveis : incuraveis
ſuppreſſoes : supressoes
inbuma : inbuma
anbuma : anbuma
eſporaõ : esporão
triangular : triangular
encontro : encontro
lagoas : lagoas
capitanias : capitanias
andaõ : andão
aves : aves
anhuma : anuma
inhuma : inuma
corno : corno
groſſura : grossura
bordel : bordel
arpa : arpa
pal : pal
mo : mo
encontros : encontros
duro : duro
eſporoens : esporoens
bezoartica : bezoartica
chamando : chamando
ſuor : suor
celebrado : celebrado
mordidos : mordidos
activo : activo
trazeiro : trazeiro
moſtraõ : mostrão
guilherme : guilherme
piſaõ : pisão
llib : lib
hiſtor : histor
natur : natur
ſect : sect
avibus : avibus
𝑓ol : 𝑓ol
soube : soube
enſinou : ensinou
vivem : vivem
naquelles : naqueles
ajuntaſſem : ajuntassem
bebeſſem : bebessem
meteſſe : metesse
ponta : ponta
lagoa : lagoa
confiadamente : confiadamente
corraõ : corrão
acontecer : acontecer
venenoſiſſima : venenosissima
morder : morder
algúa : algúa
opiniaõ : opinião
roberto : roberto
boile : boile
morde : morde
eſterco : esterco
horroroſo : horroroso
moſtrado : mostrado
foram : foram
famvarandim : famvarandim
pernambuco : pernambuco
delgadas : delgadas
ē : ē
compridas : compridas
ōs : ōs
jamvarandim : jamvarandim
milagroſiſſima : milagrosissima
pisando : pisando
pondoa : pondoa
muchiſſimo : muchissimo
cuſpir : cuspir
maſcando : mascando
infinitas : infinitas
deſcobrindo : descobrindo
dolanquim : dolanquim
excellemnte : excelemnte
eſcrevemos : escrevemos
talhadinhas : talhadinhas
eſtreitas : estreitas
chatas : chatas
comprimmento : comprimmento
ſa : sa
douradas : douradas
ſervirem : servirem
eſcrever : escrever
pagar : pagar
esbugalhaõ : esbugalhão
rebenrar : rebenrar
ſaltar : saltar
roſto : rosto
milagroſo : milagroso
caſto : casto
viſo : viso
menina : menina
repentina : repentina
olho : olho
direito : direito
improviſo : improviso
fez : fez
temiaõ : temião
rebentaſſe : rebentasse
grandeza : grandeza
creſcido : crescido
inchaçaõ : inchação
ſulou : sulou
talhadinha : talhadinha
didal : didal
negro : negro
palpebra : palpebra
cima : cima
encanto : encanto
desfez : desfez
vermelhidaõ : vermelhidão
ſuperior : superior
ſanchagem : sanchagem
preta : preta
maranga : maranga
ſemelhante : semelhante
penetrantes : penetrantes
armas : armas
balas : balas
farſeha : farseha
formará : formará
mecha : mecha
cirurgia : cirurgia
molhada : molhada
ſaliva : saliva
pulverizarà : pulverizara
meterá : meterá
advirta : advirta
contrario : contrario
ſolaparà : solapara
fecha : fecha
irà : ira
diminuindo : diminuindo
dandio : dandio
creſça : cresça
eſcuſaõ : escusão
medicamentos : medicamentos
miſter : mister
medicamento : medicamento
conſomem : consomem
eſpalhaõ : espalhão
penetrante : penetrante
fechada : fechada
lambedores : lambedores
velha : velha
cauterizada : cauterizada
lavarà : lavara
cortaõ : cortão
labios : labios
podre : podre
moleſtia : molestia
ardor : ardor
tempero : tempero
ſararà : sarara
c : c
proveitoſa : proveitosa
detrimento : detrimento
mandaraõ : mandarão
maſtigar : mastigar
lavar : lavar
maſtigada : mastigada
maſtigou : mastigou
baſejará : basejará
ccura : ccura
ſentirá : sentirá
melhoria : melhoria
propriedade : propriedade
affuguentar : affuguentar
comſigo : comsigo
iſento : isento
offendaõ : offendão
faro : faro
cheiro : cheiro
fogem : fogem
cutiladas : cutiladas
applicaõ : aplicão
calcando : calcando
cheguem : cheguem
ficando : ficando
ſolapará : solapará
une : une
canará : canará
preſta : presta
devoçaõ : devoção
noſſa : nossa
senhora : senhora
padece : padece
eſſicacia : essicacia
abundanre : abundanre
febreſinha : febresinha
lenta : lenta
ſinal : sinal
demaſiado : demasiado
cononuos : cononuos
temperamento : temperamento
ſogeito : sogeito
eſcuſar : escusar
perfeita : perfeita
proceder : proceder
abundancia : abundância
deſpede : despede
dobres : dobres
continuas : continuas
deſpediraõ : despedirão
cobres : cobres
xaropes : xaropes
aperientes : aperientes
diſſo : disso
apozemas : apozemas
purgativas : purgativas
ſogeiro : sogeiro
adoecer : adoecer
continuarem : continuarem
ellas : elas
eſtará : estará
vierem : vierem
carga : carga
delgada : delgada
virá : virá
pezar : pezar
aop : aop
fraquiſſimo : fraquissimo
ſuccede : succede
poſtraõ : postrão
baſtantes : bastantes
moe : moe
moa : moa
água : água
evacuar : evacuar
lavaõ : lavão
encorporada : encorporada
desfarà : desfara
ſede : sede
ſufficiente : sufficiente
ſatisfça : satisfça
paſſará : passará
manſamente : mansamente
porçolana : porçolana
bote : bote
ordinario : ordinario
dalla : dala
cezaõ : cezão
começar : começar
declinar : declinar
prodigioſos : prodigiosos
ſucceſſo : successo
ſangrar : sangrar
advertencia : advertencia
terà : tera
obrado : obrado
deſcançando : descançando
tornarà : tornara
principios : principios
dietas : dietas
commuas : commuas
portugueses : portugueses
frangrãos : frangrãos
pequenos : pequenos
cozidos : cozidos
compoſtos : compostos
naſcidas : nascidas
mulas : mulas
carbunculos : carbunculos
pizaduras : pizaduras
tcha : tcha
migalhas : migalhas
botarà : botara
panelinha : panelinha
gordura : gordura
tinto : tinto
deitarà : deitara
farinha : farinha
cozerà : cozera
amendoada : amendoada
padecer : padecer
acima : acima
reſpeito : respeito
aſco : asco
deitaraõ : deitarão
termo : termo
reſolvera : resolvera
reſolva : resolva
torne : torne
acudir : acudir
refreſcativa : refrescativa
deſpeça : despeça
arrancado : arrancado
untará : untará
manilha : manilha
braçal : braçal
atarà : atara
tortura : tortura
esfregaçaõ : esfregação
lavado : lavado
cubrirá : cubrirá
roupa : roupa
ſuando : suando
fucamena : fucamena
mediana : mediana
largura : largura
creſpas : crespas
cajueiro : cajueiro
particular : particular
dela : dela
ſulada : sulada
repetirà : repetira
conſentindo : consentindo
ſeque : seque
alambre : alambre
opobalſamo : opobalsamo
ropa : ropa
vantagem : vantagem
medicinas : medicinas
chamava : chamava
antigo : antigo
santo : santo
peſte : peste
manhãas : manhãas
gotas : gotas
tando : tando
conſente : consente
pegarſe : pegarse
ares : ares
maos : maos
eſcrupulos : escrupulos
ſentir : sentir
fraquezas : fraquezas
perigoſas : perigosas
paralyſia : paralisia
betonica : betonica
alfazema : alfazema
mangerona : mangerona
bolinhos : bolinhos
aſſu : assu
car : car
pingas : pingas
tocada : tocada
males : males
enfer : enfer
midades : midades
ajunta : ajunta
cachaço : cachaço
brazas : brazas
narizes : narizes
livra : livra
eſtaõ : estão
tocados : tocados
tomadas : tomadas
ſalſa : salsa
via : via
imunducias : imunducias
sara : sara
membros : membros
encolhidos : encolhidos
apoderados : apoderados
cambra : cambra
unguentos : unguentos
pertencentes : pertencentes
artemiſia : artemisia
prenhadas : prenhadas
corrimentos : corrimentos
alenta : alenta
aſſucar : assucar
algu : algu
fortifica : fortifica
digerir : digerir
paroxismo : paroxismo
queiraõ : queirão
maleitas : maleitas
catarro : catarro
tanchaª : tanchaª
gem : gem
tericia : tericia
gallinha : galinha
herva : herva
ſabina : sabina
menſtruo : menstruo
ci : ci
dreira : dreira
montã : montã
coſpem : cospem
vomitam : vomitam
cozi : cozi
pizada : pizada
foge : foge
lume : lume
ficam : ficam
atordoado : atordoado
empa : empa
chamento : chamento
lento : lento
dez : dez
compreiçaõ : compreição
mandaõ : mandão
confuſo : confuso
seguras : seguras
trabalhey : trabalhei
ſegurança : segurança
pudeſſemos : pudessemos
queira : queira
bõns : bõns
deſejo : desejo
geral : geral
aproveitamento : aproveitamento
tranquillo : tranquilo
qualidades : qualidades
eſpecifico : especifico
eſquinencias : esquinencias
inflamaçaõ : inflamação
abrandar : abrandar
fomentando : fomentando
applaca : aplaca
tumores : tumores
cauſaõ : causão
tiras : tiras
pano : pano
fios : fios
incita : incita
aplacar : aplacar
deſeca : deseca
humidades : umidades
bocadinho : bocadinho
algodaõ : algodão
molhado : molhado
ſoberano : soberano
beliolas : beliolas
enchimento : enchimento
fomentaçaõ : fomentação
purgativa : purgativa
carminativa : carminativa
ajuntandolhe : ajuntandolhe
louvarão : louvarão
fluxo : fluxo
carneiro : carneiro
lançandolhe : lançandolhe
liga : liga
enchereis : enchereis
paõ : pão
centeio : centeio
amaçado : amaçado
enfadonho : enfadonho
leitores : leitores
abbada : abbada
deſfeito : desfeito
codeço : codeço
modera : modera
parotidas : parotidas
palpitações : palpitações
hú : hú
quarti : quarti
copo : copo
minhaminha : minhaminha
quiminha : quiminha
preſtençante : prestençante
iguala : iguala
experimentou : experimentou
hu : hu
cirurgião : cirurgião
eſtrangeiro : estrangeiro
monſieur : monsieur
eſtruque : estruque
roſolgar : rosolgar
galinhas : galinhas
tiverão : tiverão
cahiraõ : cahirão
mortas : mortas
experimentar : experimentar
tinham : tinham
oſervou : oservou
eſcaparão : escaparão
flamengo : flamengo
ſolimaõ : solimão
cachorro : cachorro
cahido : cahido
ſulado : sulado
levantou : levantou
tivera : tivera
embaça : embaça
tronco : tronco
umas : umas
vergotinhas : vergotinhas
covado : covado
pontas : pontas
rara : rara
engole : engole
mutututu : mutututu
virtudea : virtudea
huas : umas
medronheiro : medronheiro
comem : comem
goſto : gosto
eryfipelas : erifipelas
teſticulos : testiculos
noras : noras
fulada : fulada
eryfipela : erifipela
inflammada : inflammada
grandiſſimo : grandissimo
condic : condic
aõ : ão
doenc : doenc
maravilhoſas : maravilhosas
bu : bu
cho : cho
ema : ema
maranhaaõ : maranhaão
gra : gra
perum : perum
tunica : tunica
membrana : membrana
contornar : contornar
froca : froca
primero : primero
caparrofa : caparrofa
noves : noves
preciſa : precisa
preparaçaõ : preparação
conſeguiraõ : conseguirão
supreſſoens : supressoens
muhamgo : muhamgo
mubamgo : mubamgo
agreſte : agreste
alemo : alemo
comprimidinha : comprimidinha
dedos : dedos
largo : largo
cheira : cheira
ja : ja
eſtà : esta
florido : florido
mato : mato
delicioſiſſimo : deliciosissimo
paraliticas : paraliticas
offendidas : offendidas
intento : intento
po : po
fevadiliha : fevadiliha
uſado : usado
affaltadas : affaltadas
pa : pa
cafange : cafange
linguas : linguas
paulo : paulo
verdadeiramente : verdadeiramente
paſſaro : passaro
eſaõ : esão
pardas : pardas
elvas : elvas
maltas : maltas
mitigaõ : mitigão
calor : calor
aliviaõ : alivião
provocaõ : provocão
atribuem : atribuem
iguaria : iguaria
comeraõ : comerão
acodindolhes : acodindolhes
eſcaparaõ : escaparão
ungida : ungida
occaſiaõ : occasião
maligniſſima : malignissima
viſinha : visinha
ſelhe : selhe
forjadas : forjadas
golpes : golpes
profundos : profundos
ſentio : sentio
aperto : aperto
ajuntey : ajuntei
lignuas : lignuas
mandey : mandei
en : en
eſtava : estava
cunhado : cunhado
pereira : pereira
pateo : pateo
galegas : galegas
feachaõ : feachão
cafondama : cafondama
bico : bico
pretas : pretas
poſtas : postas
venenoſo : venenoso
chupaõ : chupão
quieseco : quieseco
banguela : banguela
quieſco : quiesco
pão : pão
ap : ap
plicado : plicado
quicongo : quicongo
quitumbata : quitumbata
ſuſpender : suspender
camas : camas
eſtancaſſem : estancassem
veze : veze
pararaõ : pararão
foi : foi
deitarlhes : deitarlhes
ſararem : sararem
ſulando : sulando
matete : matete
porcos : porcos
alaſtrada : alastrada
chaõ : chão
cachoeira : cachoeira
nòs : nòs
groſſos : grossos
certificaraõ : certificarão
dignas : dignas
ſoccorer : soccorer
toſſigofos : tossigofos
impiematicos : impiematicos
ass : ass
ucar : ucar
roſado : rosado
cremor : cremor
cevada : cevada
obſervado : observado
menino : menino
deſamparado : desamparado
iraõ : irão
ponderar : ponderar
seguintes : seguintes
deſapaixonado : desapaixonado
entendo : entendo
ſentença : sentença
coſtume : costume
pariz : pariz
cortes : cortes
cidades : cidades
ſabem : sabem
mandaoõ : mandaoõ
fixar : fixar
ruas : ruas
praças : praças
publicas : publicas
nelles : neles
fulano : fulano
contentes : contentes
imprimir : imprimir
conta : conta
repartem : repartem
encontraõ : encontrão
pertendendo : pertendendo
ſaibaõ : saibão
achar : achar
rendem : rendem
ordinarios : ordinarios
arbitrio : arbitrio
proveitoſo : proveitoso
deſejey : desejei
execução : execução
particulares : particulares
incanſavel : incansavel
eſtudo : estudo
alcancey : alcancei
aproveitaſſem : aproveitassem
reprimi : reprimi
ſaber : saber
amargoſo : amargoso
inveja : inveja
converta : converta
julgando : julgando
ſniſtramente : snistramente
detracçoens : detracçoens
juízos : juízos
haõ : hão
encender : encender
mim : mim
cinzas : cinzas
reduziraõ : reduzirão
meus : meus
oitenta : oitenta
reſolvo : resolvo
manifeſtar : manifestar
preparo : preparo
eſtavaõ : estavão
desamparados : desamparados
deixados : deixados
arbítrio : arbítrio
tiraõ : tirão
duraõ : durão
poderiaõ : poderião
tiveſſem : tivessem
ca : ca
segredos : segredos
apontallos : apontalos
aqui : aqui
senhores : senhores
amor : amor
delaſteicaõ : delasteicão
uſſem : ussem
medicinais : medicinais
ordinarias : ordinarias
aproveitarem : aproveitarem
suppressoens : supressoens
ſeccar : seccar
curviana : curviana
abaixo : abaixo
declaradas : declaradas
rarissimas : rarissimas
bicharia : bicharia
eferupulos : eferupulos
successivos : successivos
ſubſtancia : substância
cruviana : cruviana
pílulas : pílulas
alternados : alternados
bebendolhe : bebendolhe
passadas : passadas
temperado : temperado
rais : rais
açafrão : açafrão
montão : montão
fopila : fopila
veis : veis
crocus : crocus
martis : martis
aperitivo : aperitivo
asthmaticos : astmaticos
beba : beba
hyſſopo : hissopo
deſtilada : destilada
limpa : limpa
cruezas : cruezas
vilcolos : vilcolos
durezas : durezas
peitos : peitos
escrupulos : escrupulos
quiſerem : quiserem
sobreditos : sobreditos
proveitosos : proveitosos
informarte : informarte
ficaraõ : ficarão
desenganados : desenganados
inculca : inculca
compaixão : compaixão
alheyos : alheios
deſvanecimento : desvanecimento
ambição : ambição
fama : fama
intereſſe : interesse
próprio : próprio
antidas : antidas
observaçoens : observaçoens
obſver : obsver
ſomente : somente
chamaraõ : chamarão
livraraõ : livrarão
mercê : mercê
acidentes : acidentes
gorta : gorta
entrou : entrou
hereditarios : hereditarios
fiz : fiz
republica : republica
secretos : secretos
aproveitavaõ : aproveitavão
ſouberem : souberem
faraõ : farão
niſſo : nisso
merecimento : merecimento
revelem : revelem
manufactura : manufactura
seus : seus
vivos : vivos
dem : dem
finis : finis
laus : laus
virginique : virginique
matri : matri
